-11 13 -7 5
0000000000000000000000000
0000111111100000000000000
0000111111100100000000000
0000111111100000000000000
0000111111100000000000000
0001111111100000000000000
0001111011100001000000000
0001111011100000000010000
0000000000000000000000000
0000000000000000000000000
0000000000000000000100000
0000000000000000000000000
0000000000000000000000000
